###############################
# 1111111 #         # 2222222 #
# 1111111 *         * 2222222 #
#         #         #         #
######*####  ###b#  #####s#####
#            #   #            #
#    3       #   #            #
######*####  #####  #####x#####
# 2222222 #         # 1111111 #
# 2222222 *         * 1111111 #
#         #         #         #
###############################