###############################
# # 1 #                       #
# # 1 *  #b**#                #
# s 1 #  #   #  #**b#         #
# ##*##  #   #  *1 1*         #
# #   #  *   *  #   #         #
# #   #  #   #  ##s##    ##   #
#        ##*##  #   #    *#   #
#               #   #   #11#  #
#                       f  #  #
#                      #1111x #
#                      #    # #
###############################