###############################
# # 1 #                       #
# # 1 *  #b**#                #
# s 1 #  # 11#  #**b#         #
# ##*##  # 11#  *1 1*         #
# #   #  * 22*  # 2 #         #
# #   #  #   #  ##s##    ##   #
#        ##*##  #   #    *#   #
#               #   #   #11#  #
#                       f  #  #
#                      #1111x #
#                      #    # #
###############################